||================================================================================================================||
||						      The Peak                                                    ||
||================================================================================================================||
||                                                   ~~~~--~---~--~~--~~~~~            /\        .                ||
||                                                    ~~~~~~~    ~  ~~ ~~| ~~      .   / ?\    .     .   .        ||
||                                                   ~~~~  ~  LAKE     ~ |~~~ .   ..  /+---+     .          . .   ||
||                                                    ~~~~   ~  ~~  ~   ~~~          / +---+\     .   /   .       ||
||                          @    @    VILLAGE   @       ~~-~-~~--~--~~--+      .  \ /    |.  \       / \   /\  .  ||
||                      ^        J    _        _      J        |     _||_        / \     +-   /\    /   \ /  \    ||
||           ^    ^  ^       @       /-\  @   /-\  @           |    /----\   .  /      .     /  \--/  .  /    \   ||
||            @^ ^     ^     @     +-+      +-+            @   |    -+--+-     /            / .  \           .    ||
||                              @     +-----+   ++  @          | @   |--|     /   /\   . /\/         .   /\   / . ||
||   @   ^ ^      __       @  +-------|     +-------------+    |    /+||+\       /  \   /    *       |  /  \ /    ||
||           @  =----=   ^  J |   ++  |     |  _          | +--+--+ +|--|+ .    /    /\/  +-----+----+ //   \   . ||
||^    ^   ^     |--|  -------+    _  +--+--+ /-\  @      +-|     | /----\     / You are->|  O  |   \ /          .||
||       +-----+_|  |_         @  /-\    |    +-+     J     |     | +|--|+   .     here +-|     |  / \   .    .   ||
||   @   |     |        @  @      +-+ J  | ++      @     {  +--+--+_------_     . /   . | +-----+ /   \   /\      ||
||       |     |--+@         J    ^   +--+  J               {  |    TEMPLE   || | { +-            .    \ /  \     ||
||      ^+-----+  +------+    ^ ^  ^  | ^      @ }J  {   {     |         {| {| |{ | |   .   PEAK        /  _ \    ||
||      @                |    ^^ +----++  ^           }     |  | | }| | { || | |  |   |              .    / \     ||
||@       GATES @  ^     +-------|     |^ ^            {  {    +----+  | | |{ +--   { | {  .     .       _|+|_    ||
||     ^               ^  ^  ^   |     +------------+  }   {  | } } | }| +----++{| | }  |  |            /__+__\   ||
||              ^         ^      +-----+            |    ^ }  |  |  +----|     | |{| | {} {|           / << >> \* ||
||     @  ^        ^        ^ ^         ^ ^    ^ ^^ |  ^         |} |  | |     +------------+     *    ;| <+> |;  ||
||            ^            ^    FOREST  ^  ^   ^  +---+   } ^  }   || |{ +-----+ { | |  |   | +-----+  =========  ||
||                      ^  ^ ^         ^ ^   ^ ^  +-__+  ^        }   | | BAMBOO | | |} |   +-|     |  /%<<+>>%\  ||
||             ^         ^       ^  ^      ^   ^   /__\  ^ }^  }    }  |{| GROVE |  |  {| |   |     | /|<< + >>|\*||
||                            ^        ^   ^   ^   |__| }         }    |{|    | }  }| | | |   +-----+ _|_______|_ ||
||                                 ^     ^  ^  ^         }  ^         } } }} | | }    |  {     CASTLE =========== ||
||                                    ^           HUT}       ^     }      {   {    {{       *                     ||
||                                                      }    }                            *           *           ||
||================================================================================================================||
|| Your Options are:												  ||
||================================================================================================================||